###############################
#     ..........              #
# ############# ###############
#                             #
#   #### #########            #
#      # #                    #
#      # #########            #
#                             #
###############################